NO ./assets/textures/no1.xpm
SO ./assets/textures/so1.xpm
WE ./assets/textures/we1.xpm
EA ./assets/textures/ea1.xpm

F 109,66,80
C 49,83,218


1111111111111111111
1000000000000000001
101100N000000010001
1001000001111110011
1111100000000000001
1000001111001110011
1111111111111111111